h----5--6h
--1-------
----------
----------
-4--------
-------p--
----------
-------2--
-------w--
----------
----------
s--------b

T