-----------
----222--k-
--2-----2--
-----------
-----------
----e7e----
-----p-----
----e5e----
-----------
--2-----2--
----222----

E
