h--------
--EVERY5-
---e00e--
e1e---e1e
------2--
--6----6-
---p-----

T