h--------
------e5e
---e00e--
e1e---e1e
-----e2e-
--6----6-
---p-----

T